-39
49
-50
37
00000000000000000000000000000000000000000000000000000000000000000000000000000000000000000
11111111111111111111111111111111111111111111111111111111111111111111111110000000000000000
11111111111111111111111111111111111111111111111111111111111111111111111110000000000000000
11111111111111111111111111111111111111111111111111111111111111111111111110000000000000000
11111111111111111111111111111111111111111111111111111111111111111111111110000000000000000
11111111111111111111111111111111111111111111111111111111111111111111111110000000000000000
11111111111111111111111111111111111111111111111111111111111111111111111110000000000000000
11111111111111111111111111111111111111111111111111111111111111111111111110000000000000000
11111111111111111111111111111111111111111111111111111111111111111111111110000000000000000
11111111111111111111111111111111111111111111111111111111111111111111111110000000000000000
11111111111111111111111111111111111111111111111111111111111111111111111110000000000000000
11111111111111111111111111111111111111111111111111111111111111111111111110000000000000000
11111111111111111111111111111111100000001111111111111111111111111111111110000000000000000
11111111111111111111111111111111100000001111111111111111111111111111111110000000000000000
11111111111111111111111111111111100000001111111111111111111111111111111110000000000000000
11111111111111111111111111111011101111101111111111111111111111111111111110000000000000000
11111111111111111111111111111011101111101111111111111111111111111111111110000000000000000
11111111111111111111111111111011101111101111111111111111111111111111111110000000000000000
11111111111111111111111111111011101111101111111111111111111111111111111110000000000000000
11111111111111111111111111111011101111111111111111111111111111111111111110000000000000000
11111111111111111111111111111011111111111111111111111111111111111111111110000000000000000
11111111111111111111111111111011111111111111111111111111111111111111111110000000000000000
11111111111111111111111111111011111111111111111111111111111111111111111110000000000000000
11111111111111111111111111111011111111111111111111111111111111111111111110000000000000000
11111111111111111111111111111011111111111111111111111111111111111111111110000000000000000
11111111111111111111111111111011111111111111111111111111111111111111111110000000000000000
11111111111111111111111111111011111111111111111111111111111111111111111110000000000000000
11111111111111111111111111111011111111111111111111111111111111111111111110000000000000000
11111111111111111111111111111011100000111111111111111111111111111111111110000000000000000
11111111111111111111111111111011101111111111111111111111111111111111111110000000000000000
11111111111111111111111111111011101111111111111111111111111111111111111110000000000000000
11111111111111111111111111111000001111111111111111111111111111111111111110000000000000000
11111111111111111111111111111111111111111111111111111111111111111111111110000000000000000
11111111111111111111111111111111111111111111111111111111111111111111111110000000000000000
11111111111111111111111111111111111111111111111111111111111111111111111110000000000000000
11111111100000000111111111111111111111111111111111111111111111111111111110000000000000000
11111111100111000111111111111111111111111111111111111111111111111111111110000000000000000
11111111100111111111111111111111111111111111111111111111111111111111111110000000000000000
11111111100111111111111111111111111111111111111111111111111111111111111110000000000000000
11111111100111111111111111111111111111111111111111111111111111111111111110000000000000000
11111111100000000111111111111111111111111111111111111111111111111111111110000000000000000
11111111100000000111111111111111111111111111111111111111111111111111111110000000000000000
11111111111111111111111111111111111111111111111111111111111111111111111110000000000000000
11111111111111111111111111111111111111111111111111111111111111111111111110000000000000000
11111111111111111111111111111111111111111111111111111111111111111111111110000000000000000
11111111111111111111111111111111111111111111111111111111111111111111111110000000000000000
11111111111111111111111111111111111111111111111111111111111111111111111110000000000000000
11111111111111111111111111111111111111111111111111111111111111111111111110000000000000000
11111111111111111111111111111111111111111111111111111111111111111111111110000000000000000
11111111111111111111111111111111111111111111111111111111111111111111111110000000000000000
11111111111111111111111111111111111111111111111111111111111111111111111110000000000000000
11111111111111111111111111111111111111111111111111111111111111111111111110000000000000000
11111111111111111111111111111111111111111111111111111111111111111111111110000000000000000
11111111111111111111111111111111111111111111111111111111111111111111111110000000000000000
11111111111111111111111111111111111111111111111111111111111111111111111110000000000000000
11111111111111111111111111111111111111111111111111111111111111111111111110000000000000000
11111111111111111111111111111111111111111111111111111111111111111111111110000000000000000
11111111111111111111111111111111111111111111111111111111111111111111111110000000000000000
11111111111111111111111111111111111111111111111111111111111111111111111110000000000000000
11111111111111111111111111111111111111111111111111111111111111111111111110000000000000000
11111111111111111111111111111111111111111111111111111111111111111111111110000000000000000
11111111111111111111111111111111101111101111111111111111111111111111111110000000000000000
11111111111111111111111111111111101111101111111111111111111111111111111110000000000000000
11111111111111111111111111111111101111101111111111111111111111111111111110000000000000000
11111111111111111111111111111111101111101111111111111111111111111111111110000000000000000
11111111111111111111111111111111101111101111111111111111111111111111111110000000000000000
11111111111111111111111111111111100000001111111111111111111111111111111110000000000000000
11111111111111111111111111111111100000001111111111111111111111111111111110000000000000000
11111111111111111111111111111111111111111111111111111111111111111111111110000000000000000
11111111111111111111111111111111111111111111111111111111111111111111111110000000000000000
11111111111111111111111111111111111111111111111111111111111111111111111110000000000000000
11111111111111111111111111111111111111111111111111111111111111111111111110000000000000000
11111111111111111111111111111111111111111111111111111111111111111111111110000000000000000
11111111111111111111111111111111111111111111111111111111111111111111111110000000000000000
11111111111111111111111111111111111111111111111111111111111111111111111110000000000000000
11111111111111111111111111111111111111111111111111111111111111111111111110000000000000000
11111111111111111111111111111111111111111111111111111111111111111111111110000000000000000
11111111111111111111111111111111111111111111111111111111111111111111111110000000000000000
00000000000000000000000000000000000000000000000000000000000000000000000000000000000000000
00000000000000000000000000000000000000000000000000000000000000000000000000000000000000000
00000000000000000000000000000000000000000000000000000000000000000000000000000000000000000
00000000000000000000000000000000000000000000000000000000000000000000000000000000000000000
00000000000000000000000000000000000000000000000000000000000000000000000000000000000000000
00000000000000000000000000000000000000000000000000000000000000000000000000000000000000000
00000000000000000000000000000000000000000000000000000000000000000000000000000000000000000
00000000000000000000000000000000000000000000000000000000000000000000000000000000000000000
00000000000000000000000000000000000000000000000000000000000000000000000000000000000000000
00000000000000000000000000000000000000000000000000000000000000000000000000000000000000000
